1111111111111
1C0100C0000C1
1100011011001
1P0E11E0C0001
1111111111111