1111111111111
1C010000000C1
10X0011111X01
1P0011E000001
1111111111111