1111111111111
1C00000C00011
1110011001001
1PEC001100011
1111111111111