1111111111111
1001000000011
1110011001001
1PEC111101111
1111111111111