1111111111111
1C0100C0001C1
1100011011001
1P0011E0C0001
1111111111111