1111111111111
1001000C00011
1110011001001
1PEC111100011
1111111111111