111111111111111111111111111111
1C0000000000000000000000000001
111100111100011110001111000111
100000000100000000010000000001
111100011111001111100111110011
100000000000000000000000000001
110011111111100111111111100111
1C00000000000000000000000000P1
111111111100111111111100111111
100000000100000000010000000001
110001111100011110001111000111
100000000000000000000000000001
111100011111001111100111110011
1E0000000000000000000000000001
111111111111111111111111111111